10.ox
...oo..oo...
.o..oo..ooo.
.o....oo....
...o...o.o.o
..o....o..oo
.o..........
o...o..o....
...ooo...o..
.o.oo...o...
..o...oo....
