11.ox
.o.....oo.
........o.
......o...
.....
.........o
ooo.o.o...
..o.......
.......o.o
......o...
..........
..........

