9.ox
...o.o...
.oooooo.o
o......oo
o.o.o..oo
oo.......
..ooo.o.o
...oo.oo.
o.ooooooo
..oo.....
